30
20
230333366663333300000000036633
600003066600333300002000006663
660000062030033300022200000666
600306662200033330022660000662
660306002066030333002366602262
622600003226033333222336000262
662600033223333333332200000206
226303333323333333200000002006
222233222200333333320206002026
222333322000363333222200002022
322233300222336663322200000022
002226000000000333036200000002
326330000071003333000200300000
306620000001008166606622322000
666320000011000333006020332202
663330000070003333000002200266
023000000000003333300022002666
222000000000023333220220006666
000000000222023330002277006666
222222202222200000022330006666
