10
10
6 6 6 11 1 5 1 1 3 3
5 11 6 6 7 1 1 3 3 9
5 6 6 6 1 8 1 10 3 3
11 0 6 6 3 3 1 1 3 3
10 0 0 6 3 3 3 3 3 3
0 0 6 6 3 3 3 3 3 3
0 0 6 0 3 3 3 3 3 3
0 10 0 0 3 6 6 6 3 0
0 8 0 0 0 3 11 6 0 9
0 0 0 0 0 0 8 0 1 1
