10
10
2 10 2 2 2 2 2 2 2 2
0 8 8 2 2 2 2 2 2 2
2 1 2 8 9 2 2 2 2 3
0 8 8 0 2 2 2 2 3 3
2 8 8 9 0 2 2 2 3 3
2 1 10 0 0 2 2 2 2 10
8 2 2 0 0 0 0 2 2 2
10 1 1 1 1 1 1 7 2 2
2 2 1 8 2 2 2 2 2 2
2 2 2 0 2 2 2 10 2 2
