30
20
376000606223722176330010000002
363366006232116666320070000022
666066606202110233223000000022
666665762222000308112000006100
663371760222000001272110666111
617367600022003226220000722111
673031660000037766660000176112
660600660007137116660000522112
666670600731501110006051122112
230110000717661100006005622712
330111100011501100003375522762
300777000035177000066273772100
300006600037560600002223372110
000066001706117730622222722700
001167111110770636632226523100
001766150000113336632260617100
333756766600366036662200611130
333315560003060066662235110300
651707033300700026267111270227
673607030000700222222222332225
