10
10
0 0 1 0 6 1 5 6 6 2
9 8 1 1 0 1 5 9 11 2
1 0 1 8 1 1 1 0 6 7
0 0 1 9 0 8 1 10 0 5
0 0 0 1 9 9 1 0 6 5
0 0 0 0 0 1 1 0 0 0
0 0 0 0 0 1 0 0 0 0
8 1 1 1 1 1 0 0 9 9
1 8 1 0 8 0 0 0 1 1
0 0 0 0 0 0 0 0 0 1
