30
20
222002233332000062332222071333
222222236222000062372220011300
222200302220000071311700010000
227222003322170011022200783302
337222233661173071000000173370
337220206661716666660770663372
071220006602513633620600611222
001330660222073622220606657202
002333030220333622233666666000
033333332220066627336366067222
333333300220066661336666667222
323333222200267666636566651766
222272220002221366666133661126
222212222322217111066337662326
000212233323311131000337630222
000600220003303361700711632232
000001722200333331222215630033
000002726710170332022220660003
220022562311100633332220700033
222022172256000663330227103333
