10
10
2 2 2 6 6 6 6 6 5 1
2 2 2 2 6 6 6 6 6 5
2 2 6 6 5 5 5 5 9 7
2 2 9 5 5 6 10 5 11 6
2 2 2 6 6 6 6 6 6 6
2 2 6 2 6 6 1 0 0 0
2 2 8 10 2 6 1 0 0 0
2 2 2 2 2 2 1 0 0 1
8 2 2 2 2 2 1 9 1 1
2 2 2 2 2 8 9 1 2 0
