10
10
6 6 10 6 6 6 6 2 2 2
6 6 6 6 6 6 6 2 2 2
6 6 6 6 6 6 6 2 2 7
6 11 9 6 6 6 2 2 2 9
11 6 6 0 2 11 8 1 2 2
2 2 6 6 2 2 2 1 2 2
2 2 9 0 0 0 2 2 2 2
6 8 1 0 0 2 2 0 2 2
6 6 0 0 0 2 0 0 9 0
6 6 0 0 0 0 2 0 1 0
