30
20
2 0 0 0 0 0 0 0 0 0 0 0 0 0 0 2 6 6 2 32 2 0 0 0 0 6 0 0 0 
0 0 0 0 0 0 0 2 2 2 0 3 3 0 0 0 0 6 6 33 2 2 0 0 6 6 0 0 0 
0 0 0 0 0 0 2 0 2 2 2 2 3 0 0 0 0 0 3 36 3 6 6 6 6 6 0 0 0 
0 0 0 0 0 0 0 0 2 2 0 6 0 0 0 0 2 0 3 66 6 6 0 6 0 6 2 0 0 
0 0 0 0 0 0 0 0 0 0 0 0 6 0 0 2 2 2 6 36 6 6 6 6 0 6 6 2 2 
0 0 0 0 0 0 0 0 0 6 0 0 0 0 0 0 0 0 0 00 6 6 6 0 0 0 0 2 0 
6 6 0 0 0 0 0 0 0 6 6 6 0 0 0 0 0 0 0 02 6 6 6 6 6 0 0 0 0 
6 0 0 0 0 0 0 0 0 0 0 6 0 0 0 0 0 0 0 22 2 6 6 6 0 0 6 6 6 
6 3 3 0 0 0 0 0 0 0 0 3 3 3 3 0 0 0 0 00 0 0 0 6 0 0 0 0 6 
6 6 3 0 0 0 0 0 0 3 3 3 3 6 6 0 0 0 0 00 0 0 0 6 0 0 0 0 6 
6 6 0 0 0 0 0 0 0 3 3 3 0 0 6 0 6 3 0 00 0 2 2 0 0 0 0 0 6 
6 6 0 0 0 0 0 0 0 3 3 2 2 0 0 0 3 3 3 22 0 0 2 0 6 6 6 0 6 
3 3 3 0 0 0 0 3 3 3 3 2 2 0 6 6 6 0 0 22 0 0 0 0 6 6 6 6 6 
3 0 0 0 0 0 0 0 3 3 3 3 3 3 2 2 6 3 0 23 7 1 8 3 0 6 6 0 0 
3 3 3 0 0 3 3 0 3 3 3 3 3 3 2 2 6 3 2 23 0 0 3 0 0 0 0 0 3 
2 0 3 0 0 0 7 3 3 3 3 3 2 2 2 2 0 3 2 22 0 0 3 0 0 0 3 3 3 
2 2 2 3 2 2 1 3 3 2 2 3 3 2 2 2 6 6 6 22 0 0 0 0 0 0 0 0 3 
2 2 0 3 2 2 0 3 3 3 2 2 6 6 6 6 6 6 6 62 0 2 2 0 0 0 0 0 3 
2 2 6 3 3 2 2 3 3 3 2 2 6 6 6 6 6 6 6 66 0 2 2 2 3 3 3 0 0 
0 0 6 6 6 2 2 3 3 6 2 2 0 0 3 3 0 0 6 60 0 2 2 2 3 3 3 0 0 
