30
20
0 0 0 0 3 0 0 6 0 6 0 0 2 2 6 6 0 0 6 03 0 0 0 2 2 6 6 3 3 
0 0 0 0 3 3 0 0 0 0 0 2 2 3 0 0 0 6 6 00 0 3 3 2 6 6 3 3 3 
0 0 0 2 3 3 0 0 0 0 0 2 2 2 0 0 0 6 6 03 2 2 3 6 6 0 0 3 3 
0 0 0 0 0 0 0 0 0 0 0 0 2 2 0 0 3 3 3 00 2 0 2 0 0 0 2 3 3 
0 0 0 0 0 0 0 0 0 2 2 0 2 0 0 0 3 3 3 00 0 0 0 0 0 2 2 2 3 
0 6 6 6 0 0 6 6 2 2 2 0 0 0 0 6 3 3 3 03 0 0 0 0 0 0 2 2 0 
2 2 6 6 0 0 6 6 2 2 2 0 2 6 6 6 3 3 3 30 6 0 0 0 0 0 0 0 0 
2 2 6 0 0 6 6 2 2 2 2 2 2 2 0 2 3 3 0 33 6 6 0 0 0 0 0 0 0 
2 0 2 2 2 0 2 2 2 2 2 2 2 2 0 3 0 6 6 00 6 6 6 0 0 0 0 0 0 
2 0 0 2 2 2 2 2 2 0 6 2 2 2 0 0 0 6 0 00 6 6 6 6 0 2 0 0 0 
2 2 2 2 2 2 0 2 2 0 6 6 2 2 3 3 0 6 0 00 0 2 2 2 0 2 0 0 0 
2 2 2 2 2 2 2 2 2 0 6 3 3 2 3 3 0 0 0 00 0 0 2 2 2 2 6 6 0 
2 2 2 3 2 3 3 0 0 2 6 6 2 2 3 0 0 0 0 00 0 3 3 3 2 3 6 6 6 
2 2 2 2 2 2 3 0 2 2 6 2 2 2 3 0 3 6 0 00 3 3 3 3 3 3 6 6 6 
2 6 1 1 1 2 3 3 0 2 2 2 6 6 3 3 3 0 0 02 3 3 3 3 3 3 6 0 6 
0 2 1 7 1 5 6 6 3 2 2 2 6 6 6 3 3 2 0 00 0 0 3 3 3 6 3 6 6 
2 2 2 0 2 8 6 6 3 2 2 2 2 2 2 2 2 2 0 06 0 0 0 0 0 6 6 6 6 
2 2 2 0 6 7 0 3 3 2 0 0 0 2 2 2 2 6 0 66 0 0 0 0 0 6 6 0 0 
0 2 2 0 0 1 5 7 3 2 2 0 0 0 2 2 6 6 6 66 2 2 2 0 6 6 6 0 3 
2 2 2 2 0 0 6 0 0 2 0 0 0 0 2 2 6 6 2 22 2 2 2 0 0 0 0 6 6 
