30
20
3 3 3 3 3 3 3 3 0 0 2 2 0 0 0 0 6 0 0 00 0 0 0 0 0 0 3 3 0 
3 3 3 0 0 0 3 3 7 7 2 2 2 2 0 6 2 2 0 00 0 0 0 2 2 6 6 0 0 
3 0 0 0 0 0 2 0 3 0 2 2 2 0 2 6 6 6 6 00 0 0 2 1 8 2 2 0 0 
3 0 0 0 0 2 2 0 0 0 2 2 2 2 2 2 2 0 3 00 0 0 0 1 2 6 6 3 3 
0 0 0 0 2 2 2 0 0 0 2 2 2 2 2 3 3 3 0 00 6 3 6 7 6 6 6 3 3 
0 2 2 2 2 2 0 0 0 0 2 2 2 2 2 3 2 2 0 00 3 3 6 6 0 0 0 0 0 
0 3 2 2 2 2 6 6 6 0 0 2 2 2 3 3 2 0 0 00 0 3 3 0 0 0 0 0 0 
0 3 3 3 2 2 0 6 6 0 0 2 6 2 2 2 2 2 2 00 2 0 0 2 2 6 0 0 0 
3 3 3 3 3 0 0 0 2 0 6 0 6 0 6 2 2 0 0 00 2 2 2 2 2 2 2 0 0 
3 3 3 3 3 0 2 2 2 2 6 6 6 6 6 6 0 0 2 20 2 0 2 0 0 6 0 0 0 
0 3 3 3 6 6 2 2 2 6 6 6 6 0 2 6 2 2 2 02 2 2 0 0 2 0 0 6 6 
0 3 3 3 0 6 6 2 2 0 6 6 6 0 2 2 2 2 2 22 2 2 2 0 0 0 0 6 6 
0 0 3 3 0 3 6 2 2 2 0 0 0 0 0 2 2 0 2 20 2 2 2 2 2 0 2 1 7 
0 3 0 0 2 3 6 2 2 2 0 0 0 2 2 2 2 0 0 03 0 0 2 6 0 0 0 1 1 
7 3 0 2 2 6 0 0 0 0 0 0 0 0 0 0 0 0 0 03 0 2 3 3 3 0 0 2 2 
3 3 0 0 0 6 0 0 0 0 0 0 0 0 0 0 0 0 0 03 0 0 0 0 0 0 0 0 0 
6 3 0 0 2 6 6 0 0 0 0 0 3 0 3 0 0 3 0 33 3 2 2 6 6 6 0 0 0 
6 3 3 6 6 6 6 0 0 0 0 0 3 0 6 0 2 3 0 33 3 2 3 3 6 6 0 0 0 
0 0 3 0 6 6 0 0 0 0 3 3 3 3 6 6 6 0 0 33 3 3 3 3 0 0 0 0 0 
0 6 6 0 6 6 2 2 0 0 3 2 2 2 6 6 0 0 0 33 3 2 3 3 0 3 0 0 0 
