10
10
1 0 0 3 3 3 3 3 3 3
1 0 0 0 0 0 3 8 10 3
9 0 0 0 0 0 0 3 3 3
0 0 0 2 2 2 2 2 0 3
0 8 1 0 2 1 8 2 3 3
0 0 1 0 0 1 8 2 2 2
0 0 8 0 1 8 2 2 2 3
0 0 0 7 1 9 2 2 2 0
0 0 10 1 0 0 2 2 2 0
0 0 0 0 0 2 2 8 9 0
