30
20
000000022000000000003367000066
300020002200022206001151000066
333331117666002666001117000066
326667021666606626611667000006
222662226000066626076660600000
226762266630706627111556626000
207162220030766322111110626600
220000360660063332011000022262
020000306666666333000006222302
002200066066606660011100002222
222206666663300630010700003226
332226000600000030070000303332
332206000000000036000000303620
332200000000000036000003000000
006260000111173333366000066066
666660600000003326666600060006
666200660000002276666000200006
666330663000003317666000772222
663333623300003333300000100007
663338222200003333330000000071
