30
20
022200022203303300006666666600
022200222203003300000666666663
002200022203220000026636666633
000000000003222203022036266622
000330000000222000022002222622
662230000002222200022000026666
622200000000202200002060022666
022000000002206600022060078666
062000020322033300322066616600
626200006366003333033006600020
666000206366033331100036000022
666062200333660337700036600022
666222663336500333003336333032
666222000665133333000200232230
660002200666562333303200332233
000020000007120003203302362233
036336770222220003066302222662
066326622220200033666332207122
003333222222203063666662266522
600333322002223300666600006766
