10
10
0 0 0 0 0 0 0 0 0 0
0 0 0 0 0 0 0 0 0 0
0 0 0 0 0 0 1 1 10 0
0 0 0 0 0 1 1 1 1 9
0 10 0 1 1 1 0 10 8 8
8 1 10 1 0 1 0 0 0 0
0 0 1 1 1 0 0 0 0 8
1 0 0 0 3 0 0 0 0 0
1 0 0 3 3 0 0 10 3 3
8 3 3 3 9 7 0 10 3 3
