10
10
2 2 2 2 2 2 2 2 2 2
2 2 2 2 2 2 2 2 0 2
2 2 2 2 2 2 0 0 0 2
2 2 2 2 2 2 2 0 0 7
8 1 2 2 2 2 2 0 2 1
1 1 1 2 2 2 2 0 2 1
1 0 7 1 2 2 2 2 2 2
0 0 0 7 2 2 0 0 0 0
0 0 0 2 0 0 0 0 0 0
0 0 0 0 0 0 0 0 0 0
